------------
--...R....--
--.------.--
--.------.--
--....P..+--
------------